11111111111
10000000001
10001111111
1X00E000001
10000000001
1000X000C01
11111000001
1X0000PC001
11111111111